{
    "map":[
        { "name":"溪流秘谷",
          "terrain":[
              [3, 3, 4, 1, 1, 4, 3, 3, 3, 4, 8, 3, 3, 1, 1, 4, 3, 3],
              [3, 1, 1, 1, 4, 1, 1, 1, 1, 1, 2, 1, 4, 1, 1, 1, 1, 3],
              [1, 0, 0, 0, 0, 1, 4, 4, 1, 6, 8, 1, 1, 1, 1, 1, 4, 1],
              [0, 0, 1, 4, 0, 0, 0, 0, 6, 6, 0, 0, 0, 0, 4, 1, 0, 0],
              [1, 4, 1, 1, 1, 1, 1, 8, 6, 1, 4, 4, 1, 0, 0, 0, 0, 1],
              [3, 1, 1, 1, 1, 4, 1, 2, 1, 1, 1, 1, 1, 4, 1, 1, 1, 3],
              [3, 3, 4, 1, 1, 3, 3, 8, 4, 3, 3, 3, 4, 1, 1, 4, 3, 3]
          ]
        },
        { "name":"沙漠之眼",
          "terrain":[
              [9, 9, 9, 9, 9, 9, 0, 0, 0, 0, 0, 0, 9, 9, 9, 9, 9, 9],
              [9,12, 0, 0, 0, 0, 0,10, 1, 1,10, 0, 0, 0, 0, 0,12, 9],
              [9,13,13,13, 9,12, 0, 4, 9, 9, 1, 0,12, 9,13,13,13, 9],
              [9,13,13,13, 9, 9, 0, 9, 7, 7, 9, 0, 9, 9,13,13,13, 9],
              [9,13,13,13, 9,12, 0, 1, 9, 9, 4, 0,12, 9,13,13,13, 9],
              [9,12, 0, 0, 0, 0, 0,10, 1, 1,10, 0, 0, 0, 0, 0,12, 9],
              [9, 9, 9, 9, 9, 9, 0, 0, 0, 0, 0, 0, 9, 9, 9, 9, 9, 9]
          ]
        },
        { "name":"雙橋逆波",
          "terrain":[
              [1, 1, 1, 1, 1, 3, 3, 3, 3, 3, 3, 3, 3, 1, 1, 1, 1, 1],
              [0, 0, 0, 0, 0, 0, 0, 0, 0, 0, 0, 0, 0, 0, 0, 0, 0, 0],
              [1, 1, 1, 1, 1, 1, 2, 5, 1, 1, 5, 2, 4, 1, 1, 1, 1, 1],
              [7, 7, 7, 7, 7, 7, 2, 7, 7, 7, 7, 2, 7, 7, 7, 7, 7, 7],
              [1, 1, 1, 1, 1, 4, 2, 5, 1, 1, 5, 2, 1, 1, 1, 1, 1, 1],
              [0, 0, 0, 0, 0, 0, 0, 0, 0, 0, 0, 0, 0, 0, 0, 0, 0, 0],
              [1, 1, 1, 1, 1, 3, 3, 3, 3, 3, 3, 3, 3, 1, 1, 1, 1, 1]
          ]
        },
        { "name":"凜冬棲地",
          "terrain":[
              [3, 3, 3, 3, 0, 1, 4, 1, 0, 0, 0, 1, 1, 4, 0, 3, 3, 3],
              [3, 0, 0, 0, 0, 1, 4, 0, 0, 4, 0, 0, 1, 1, 4, 0, 0, 0],
              [0, 0, 0, 0, 0, 1, 1, 0, 0, 7, 7, 0, 0, 0, 0, 0, 0, 0],
              [0, 0, 0, 0, 0, 0, 0, 0, 0, 0, 0, 0, 0, 0, 0, 0, 0, 0],
              [0, 0, 0, 0, 0, 0, 0, 7, 7, 0, 0, 1, 1, 0, 0, 0, 0, 0],
              [0, 0, 0, 4, 1, 1, 0, 0, 4, 0, 0, 4, 1, 0, 0, 0, 0, 3],
              [3, 3, 3, 0, 4, 1, 1, 0, 0, 0, 1, 4, 1, 0, 3, 3, 3, 3]
          ]
        },
        { "name":"西風哨站",
          "terrain":[
              [1, 1, 1, 1, 1, 0, 0, 0, 0, 0, 0, 0, 0, 1, 1, 1, 1, 1],
              [1, 1, 4, 1, 1, 0, 4, 4, 3, 3, 4, 4, 0, 1, 1, 4, 1, 1],
              [1, 1, 1, 1, 1, 0, 4, 5, 3, 3, 5, 4, 0, 1, 1, 1, 1, 1],
              [0, 0, 0, 0, 0, 0, 0, 0, 0, 0, 0, 0, 0, 0, 0, 0, 0, 0],
              [1, 1, 1, 1, 1, 0, 4, 5, 3, 3, 5, 4, 0, 1, 1, 1, 1, 1],
              [1, 1, 4, 1, 1, 0, 4, 4, 3, 3, 4, 4, 0, 1, 1, 4, 1, 1],
              [1, 1, 1, 1, 1, 0, 0, 0, 0, 0, 0, 0, 0, 1, 1, 1, 1, 1]
          ]
        },
        { "name":"破碎斷崖",
          "terrain":[
              [11,11,11, 0, 1, 1, 1,11,11,11,11,11,11, 1, 1, 0,11,11],
              [ 1, 1, 0, 0, 1, 4, 4, 1, 1, 1,11, 4, 1, 1, 4, 0, 0,11],
              [ 1, 0, 0, 0, 0, 0, 4, 0, 5, 0, 1, 0,14, 1, 0, 0, 0, 0],
              [ 0, 0, 0, 0, 0, 0, 0, 0, 0, 0, 0, 0, 0, 0, 0, 0, 0, 0],
              [ 0, 0, 0, 0, 1,14, 0, 1, 0, 5, 0, 4, 0, 0, 0, 0, 0, 1],
              [14, 0, 0, 4, 1, 1, 4,14, 1, 1, 1, 4, 4, 1, 0, 0, 1, 1],
              [14,14, 0, 1, 1,14,14,14,14,14,14, 1, 1, 1, 0,14,14,14]
          ]
        },
        { "name":"紛爭平原",
          "terrain":[
              [1, 1, 1, 1, 1, 1, 3, 3, 3, 3, 3, 3, 1, 1, 1, 4, 1, 1],
              [1, 1, 1, 1, 3, 1, 1, 4, 1, 0, 0, 0, 0, 0, 1, 1, 1, 1],
              [1, 1, 1, 1, 1, 1, 4, 1, 1, 0, 6, 6, 1, 0, 1, 1, 4, 1],
              [0, 0, 0, 0, 0, 0, 1, 1, 1, 0, 1, 1, 1, 0, 1, 1, 1, 1],
              [1, 4, 1, 1, 1, 0, 6, 6, 1, 0, 1, 4, 1, 0, 0, 0, 0, 0],
              [1, 1, 1, 1, 1, 0, 0, 0, 0, 0, 4, 1, 1, 3, 1, 1, 1, 1],
              [1, 1, 4, 1, 1, 1, 3, 3, 3, 3, 3, 3, 1, 1, 1, 1, 1, 1]
          ]
        },
        { "name":"海角之淚",
          "terrain":[
              [0, 0, 0, 7, 7, 7, 7, 3, 3, 3, 3, 7, 7, 7, 7, 0, 0, 0],
              [0, 0, 0, 2, 2, 2, 1, 1, 6, 6, 1, 1, 2, 2, 2, 0, 0, 0],
              [0, 0, 0, 7, 7, 7, 1, 6, 6, 6, 6, 1, 7, 7, 7, 0, 0, 0],
              [0, 0, 0, 7, 7, 7, 1, 6, 6, 6, 6, 1, 7, 7, 7, 0, 0, 0],
              [0, 0, 0, 2, 2, 2, 1, 1, 6, 6, 1, 1, 2, 2, 2, 0, 0, 0],
              [0, 0, 0, 7, 7, 7, 7, 1, 1, 1, 1, 7, 7, 7, 7, 0, 0, 0],
              [0, 0, 0, 7, 7, 7, 7, 7, 7, 7, 7, 7, 7, 7, 7, 0, 0, 0]
          ]
        },
        { "name":"空中庭院",
          "terrain":[
              [11,11,11,11,11,11,11,11,11,11, 0, 0, 0, 0, 0, 0, 0,11],
              [11,11, 0, 0, 0, 0, 0, 0, 0, 0, 0,11,11,11,11,11, 0,11],
              [11,13,13,13, 0, 0, 0, 0,12, 1, 1,11,11,11,13,13,13,11],
              [11,13,13,13,11,11,11, 1, 1, 1, 1,11,11,11,13,13,13,11],
              [11,13,13,13,11,11,11, 1, 1,12, 0, 0, 0, 0,13,13,13,11],
              [11, 0,11,11,11,11,11, 0, 0, 0, 0, 0, 0, 0, 0, 0,11,11],
              [11, 0, 0, 0, 0, 0, 0, 0,11,11,11,11,11,11,11,11,11,11]
          ]
        },
        { "name":"溶光洞窟",
          "terrain":[
              [15,15, 0, 0, 0, 0, 0, 0, 0, 7, 7, 7, 7, 0, 0,15,15,15],
              [ 0, 0, 0, 0, 0, 1,12, 4, 0, 2, 1, 1, 0, 0, 4, 0, 0, 0],
              [ 0, 0, 0, 0, 0, 1, 1, 0, 0, 6, 0, 1, 0, 0, 0, 0, 0, 0],
              [ 0, 0, 0, 0, 0, 0, 0, 0, 6, 6, 0, 0, 0, 0, 0, 0, 0, 0],
              [ 0, 0, 0, 0, 0, 0, 1, 0, 6, 0, 0, 1, 1, 0, 0, 0, 0, 0],
              [ 0, 0, 0, 4, 0, 0, 1, 1, 2, 0, 4,12, 1, 0, 0, 0, 0, 0],
              [15,15,15, 0, 0, 7, 7, 7, 7, 0, 0, 0, 0, 0, 0, 0,15,15]
          ]
        }
    ]
}
